R  800 800
SO south.cub
NO north.cub
WE west.cub
EA east.cub
S  sprite.cub
F 253,14,255
C 100,10,222

111111111
100002001
100002001
100002001
10000N001
100000001
120200201
100000001
111111111