R  800 800
SO south.c
NO north.cub
WE west.cub
EA east.cub
S  sprite.cub
F 253, 14,255
C 100,10,222

111111111
100000001
100000001
100000001
10000S001
100000001
100200001
100200001
111111111