R  800 800
SO textures/south.xpm
NO textures/north.xpm
WE textures/west.xpm
EA textures/east.xpm
S  textures/sprite.xpm
F 253,14,255
C 100,10,222

11111
10001
10101
10N01
11111