R  400 400
SO textures/north.xpm
NO textures/south.xpm
WE textures/west.xpm
EA textures/east.xpm
S  textures/miniman.xpm
F 255,255,0   
C 0,255,0 

1111111111
1000000001
1000220101
1000N00001
1111111111