R  700 700
SO textures/south.xpm
NO textures/north.xpm
WE textures/west.xpm
EA textures/east.xpm
S  textures/barrel.xpm
F 255,255,1   
C 0,255,0

111111
100001
100001
12N021
100111
1101011
120011
111111


