R  800 800
SO textures/north.xpm
NO textures/south.xpm
WE textures/west.xpm
EA textures/east.xpm
S  textures/north.xpm
F 253,14,255
C 100,10,222

1111111111
1000000001
1000200101
10N0000001
1111111111