111111
102001
102001
12N021
120021
111111


R  700 700 
SO textures/north.xpm
NO textures/south.xpm
WE textures/west.xpm
EA textures/east.xpm
S  textures/knight.xpm
F 255, 255,1   
C 0,255,0 
