R  200 500
SO south.xpm
NO north.xpm
WE west.xpm
EA east.xpm
S  sprite.xpm
F 253,14,255
C 100,10,222

111111111
1N1
111