R  800 800
SO south.c
NO north.cub
WE west.cub
EA east.cub
S  sprite.cub
F 253, 14,255
C 100,10,222

111111111111
100000000001
120200200021
100000000001
12000N000021
100000000001
102000002001
111111111111